111111111111111111111111111111111111111111
1001110000000000010000000000000000000000C1
100P00100000000100000000000000000000C00001
100111000000000000C00000000000100000000001
100000000000000000000000000000110000000001
100H00000000000000000000000000110000000001
100000000001000000000H00000000110000000001
100C00000001C00000000000001100110000000001
100000000001000000000000000000000000000001
100H00000000000000000000000000110000000001
100000000001000000000H00000000110000000001
100C00000001C00000000000001100110000000001
100000000001000000000000000000000000000001
100000000000000000000000000000000000C00001
100000000001000000000000001000000000000001
100000000001000000000000000000111000000001
100000000001000000000000000000000000000001
100C00000000000000000000000000C00000000001
100000000001000000000001111111100000000001
100000000000000000000000000000000000000001
100C00H00000000000000000000000C00000000001
100000000001000000000001111111100000H00001
100000000000000000000000000000000000000001
100000000000000000000000000000000000001101
100000000111011100000110111000000000001101
100000000111C111000001111C00100000000011E1
111111111111111111111111111111111111111111
